[7, 7, 7, 7, 7, 7, 7, 7, 8, 8, 8, 8, 8, 7, 7, 7, 7, 7, 7, 7]
[7, 0, 0, 0, 0, 0, 0, 7, 8, 0, 5, 0, 8, 7, 0, 7, 3, 0, 0, 7]
[7, 0, 7, 7, 0, 7, 0, 7, 8, 0, 0, 0, 8, 7, 0, 7, 7, 7, 0, 7]
[7, 0, 7, 3, 0, 7, 0, 7, 7, 7, 1, 7, 7, 7, 0, 0, 0, 7, 0, 7]
[9, 0, 7, 7, 7, 7, 0, 0, 0, 7, 1, 7, 0, 7, 7, 7, 0, 0, 0, 7]
[7, 0, 0, 0, 0, 7, 0, 7, 0, 0, 0, 7, 0, 7, 0, 0, 0, 7, 0, 7]
[7, 7, 7, 1, 7, 7, 0, 7, 7, 7, 7, 7, 0, 7, 1, 7, 7, 7, 0, 7]
[7, 0, 7, 0, 0, 7, 0, 1, 0, 0, 0, 0, 0, 7, 0, 7, 3, 7, 3, 7]
[7, 0, 7, 7, 0, 7, 7, 7, 7, 0, 7, 7, 7, 7, 0, 7, 0, 7, 7, 7]
[7, 0, 0, 0, 0, 0, 0, 0, 7, 0, 0, 0, 0, 7, 0, 7, 0, 7, 0, 7]
[7, 0, 7, 7, 0, 0, 0, 7, 7, 7, 7, 7, 0, 0, 0, 7, 0, 7, 0, 7]
[7, 0, 7, 0, 0, 7, 7, 7, 0, 0, 0, 7, 7, 7, 0, 7, 0, 7, 0, 7]
[7, 3, 7, 0, 0, 7, 0, 0, 0, 7, 0, 0, 0, 7, 0, 0, 0, 7, 0, 7]
[7, 7, 7, 7, 0, 7, 1, 7, 7, 7, 0, 0, 0, 7, 7, 7, 7, 7, 0, 7]
[7, 0, 1, 0, 0, 7, 0, 0, 3, 7, 1, 7, 0, 0, 0, 7, 0, 0, 0, 7]
[7, 0, 7, 0, 0, 7, 0, 7, 7, 7, 0, 7, 7, 7, 0, 7, 0, 7, 0, 7]
[7, 0, 7, 7, 7, 7, 0, 7, 0, 0, 3, 0, 0, 7, 0, 7, 0, 7, 0, 7]
[7, 0, 7, 0, 0, 0, 0, 7, 0, 0, 4, 0, 0, 7, 0, 7, 0, 7, 0, 7]
[7, 0, 0, 0, 0, 7, 0, 7, 0, 0, 6, 0, 0, 7, 0, 0, 0, 7, 3, 7]
[7, 7, 7, 7, 7, 7, 7, 7, 7, 7, 7, 7, 7, 7, 7, 7, 7, 7, 7, 7]
